***********************************************************
*................*........................................*
*.****.********..*.******.*..***************************..*
*.*..*.*...........*......*.....*...*...*...*...*......*..*
*.*..***..******.***..*.*.*..*....*...*...*...*....***.*..*
*....*....*..*...*...**.*.*..******.*.************.*.*.*..*
***..*..*.*..*...*.*....*...........*...*..........*...*..*
*.*.....*.*..*...*.*.***********...**.*.*.**************..*
*.*********..*...*.*.*.........*...*..*.*.................*
*................*.*.*.*..*....**.**..*.************.******
*.********..******.*.*.*..*...........*.*.................*
*.*...........*....*.*.************...*.*.*********.*******
*.*.*.*.*...*....*.*.*................*.*.*...............*
*.*.*.*.*...******.*...******.******..*.*.*.************..*
*.*.*.*.*............*.*...........*..*.*.*............*..*
*.*.***.************.*.*.*.*.*.*.*.*..*.*.*.**********.*..*
*...*...*...*........*.*.*.*.*.*.*.*..*.*.*..........*.*..*
***.*.***.*.*.********.*.........*.*..*.*.*..******..*.*..*
*.........*..............*.*.*.*..........................*
***********************************************************