************************************************************
*............................*...................*.........*
*.****.*.******************..*.***********.*****.*********.*
*.*..*.......................*...*...........*.............*
*.*..*******.*.*****.***********.*.*.*******.*************.*
*............*.*.*...............*.*.*...........*.......*.*
**************.*.*************.***.****.******.*.***.*.***.*
*................*...............*...........*.*.....*.....*
*.****************.***.*************.*********.***********.*
*....................*.......*...............*.............*
*.********************.***.*.*.***.*.*******.*.***.*********
*................*.....*.*.*.*.*.*.*.*.......*.*.*.......*.*
*..***********.*.*****.*.*.*.*.*.*.*.*.*******.*.*.*.*****.*
*.**.*.*...*.*.........*.*.*.*...*.*.*...........*.*.*.....*
*.*..*...*.*.***********.*.*****.*.*.*.***********.***.*.*.*
*.**...*.*.......................*.*.*.................*.*.*
*..*.***.**********..*********..**.*.*.*******************.*
*.**.*...........*..**.*...*.**..*.*.*...................*.*
*.*..*.***.*****.....*.*.*.*.*..****.******************.**.*
*........*.......*.......*...........*.....................*
************************************************************